mom: wmx kcq uci
csg: jfm qvq
dvy: izj jju xwd
coz: lif
fkq: coz adu qpj
iue: vvg vsq fqc
zft: neu wcf
wav: ley zfi
pow: srr
leo: uds mfr kpx
bzn: drt tgm
ttw: fyt xun
ykf: hzu
srr: lzo fip
imx: odx
snc: dvp myq
ftp: jcw
pld: bhv qbc
yiy: tgy shs fkf
lbl: csk
dtv: qbc nhi uej
oto: nhi bhv uej
zat: out
vzn: out
dgd: fap bho ysa
uia: xoa gyi swx
bup: zfi ley you
kfg: jzj tvb
xym: xup ala
zjo: hdc lrn ohp
kck: hri ktw
rbp: zat
ayu: iqo epv uia
obb: boa
dov: qln zsj
jov: out
xmq: ray skh cvg
xps: aoz qpj
nub: gao xou owe
fqu: dxf
kgm: zar lpi zjo
qfi: klj tep
wii: lpi
rfl: trs mtc kfg
fft: pow rbx pqs
bme: vdk dem mts
vmn: dvy kui
rli: bfa dzl
byq: out
kjr: uej bhv
ray: qxa bme spk
fpf: ehx gsm
kep: gso
xma: owc fip
emz: kbp coj tfe
ltc: dvy ulr vym
ubj: jov
riq: aox fca fkz
hzr: skw ksh fft
gep: enn
ssi: cha
zti: mrn fqc vsq
ypm: ppv pet aof
pjl: gev bnb
xqi: wme
gdm: owc fip ppc
djn: hzk wws evk
bho: uej bhv nhi
hyc: mud rbp gos
gso: gep sys
smj: pjl ogy
edr: vyo pgz ocq
knp: dwd
dwv: bvy jcw
ggk: rli nug zwu
dvh: neu wcf qoy
mhg: now oza
fap: bhv uej qbc
ipf: owc
czd: fsu mzg
iuy: rqz pks
xjf: wve yat
zss: ktw cvs
ntn: abd bnv vzn
vxi: udz rwx
zwu: hsw
wmx: rjm
sgb: bme
tks: yjf ycm gyj
dzl: fip ppc lzo
mvg: wpc gsm
pmq: ocq
lif: jqc knp mbz
dem: hzr hkh fvc
lgs: wii hus nol
ulr: zsc xwd jju
vul: bjt
sqt: ypz cme gcr
doo: nhi uej
zjt: smj
auy: dbz
aoq: pfr sah
jps: snc nls
lnz: mkl bjt
ogy: bnb qyv
rpb: vul yhu und
tnx: cse qci knk
bnb: zfi slr
eot: jne sys nkm
mns: xzd pmx
dxf: uej qbc
wfs: rqz eir
aom: shg kqk
dbv: ptr
zfs: iqy
trs: tvb fqe
qoy: zfm tks
ngi: slr zfi
ptr: rqh uzc
tsa: nls csk
lzo: ksy kkc ssx
ptf: qxa nha bme
xnx: ihx hfw
odx: rqh dgd
vrk: xup
yhu: zfs lwx hpa
qmy: wwq
cpg: dac xak way
ebe: dtv fpm iea
xxc: bhv uej qbc
ubn: spk
fbp: ucv tap
sah: vfj
ibd: byq
zsc: xmq nnr
lnt: nol kgm wii
aoz: mso gsa lif
zcl: fol
rwe: bzn now
zdj: gos
eir: bhv uej qbc
sjv: ynw mok
bcj: qxa bme
bvy: ntm euh
kkc: vvs dbv imx
fqe: qxa nha
pks: rpb uej qbc
xyc: bup
mrc: tyb cly rmd
qsw: jul
jcw: ntm euh
lpb: wgs
jol: out
zxa: ubn bcj ptf
jju: aai zie
ssx: otz kpx mfr
zsj: wgs mrc
mok: nef
qpj: gsa
aox: ssd lxh
sys: pju
obg: tjv
inr: pbn
dcf: ggk ntm
jqc: sat
qbc: fbd kep wsy
adu: gsa lif
euh: nug
dac: kof ezt
wch: tjv clq xpe
hsw: lzo fip
skh: spk bme
boa: jol
qtg: rvw xep joz
myq: mrc wgs
gej: rpb uej bhv
bvk: mns knk qci
hau: jcw
mtc: fqe
kdx: qxa nha spk
pzn: wgs mrc ktw
gos: yfr axv
svr: mga kph atu
kui: izj
jgm: cvs hri ktw
gnf: jov jol
dbz: mzg iwa
cha: ala gnz
uxo: swx
pqs: srr acx
kar: soc auy fnj
ynw: nef zuk puq
puq: gdm msy ipf
awk: bvy
woa: uiq qfu xec
fqc: ppc
vsq: ppc
nsy: afk cpg rfu
way: bsw ngi kof
tsj: ktw hri mrc
now: ypm
zth: dgm
owe: pca doo pld
zjg: eup ipf msy
dcx: gev
nkm: uaz jxx
nwm: deg
klj: uci wmx ume
nwg: rpb nhi qbc
yla: fzm xhm xvv
bjt: jne nkm sys
vdk: bvy jcw dcf
qci: qat xzd ubo
bst: tfe coj zyn
sat: out
ocq: smz
gev: you slr
sod: xyc fbp kvg
wme: ptr ljp
ugt: uej qbc nhi
hzu: nha
fsj: jul
wvn: jxz hpa lwx
afk: dac way
rbx: srr owb
ucv: zfi slr
tfe: hij kdx sgb
deg: owc
pca: rpb uej bhv
xun: zdj hyc
emi: bzn now
irx: kbp yjd coj
wgs: cly tyb khg
lpi: ohp
khg: zep pbn
yjd: kdx
pju: jgm pzn ruu
yhm: zjg nef
jvc: knk cse
gyi: flj
axv: out
yzc: acs lpb
ljp: rqh dgd mxn
lhq: ezt kof ngi
yku: srr owb
bsw: you ley zfi
zfm: ycm gyj
acs: wgs hri ktw
upm: out
jec: ocq pgz
und: rwx udz dov
sua: sjv
dvp: cvs hri mrc
tew: kfg
tkq: khi kqk
cme: zfi ley
iit: you ley slr
xpe: nub nzl gbn
kkd: xou xie gao
ycm: nha qxa spk
fkf: iue zti jsk
mga: ssi hpr irx
szn: out
qxa: ftp kch ksu
ymk: ebe
llv: rfu afk
skw: yku rdn rbx
rkv: czd ajx uok
ckm: lhq dac way
jqx: srm
fol: out
byx: ugt xxc
hus: lpi zar
uea: lzo owc fip
pcj: zfi you
you: unr vkb ncq
lxh: szn vkm fol
hyk: yti zxa ykf
mzg: ixw
sob: uej rpb bhv
mkl: jne
nug: hsw bfa
yjf: nha spk bme
uuw: jpv qpj coz
gnz: nha spk bme
mrn: fip lzo owc
hdc: xyk jzb
kvg: iit tap bup
mud: yfr axv
cvg: nha
woi: xvv
mso: dfz jqc knp
qsj: pks
rmd: ckm rfu
eja: ycm gyj
wbd: lpb fzh tsj
kof: slr zfi ley
ajx: fsu fqu
vym: izj jju xwd
rzp: dzl
ypz: you
aof: ubj gnf jqx
hpr: epv iqo uxo
ohp: jzb ntn hsv
vjg: gfq ynw
ktw: zjt edr jec
xvv: tsa jps bik
coj: sgb hij kdx
shs: iue jsk
alx: qvq qui riq
fkz: ssd zcl
fzm: yum lbl bik
zao: qiu xep joz
aum: ulr dvy bri
nnr: skh cvg iaz
vlx: mrc wgs ktw
uqp: kqk shg
kcq: rjm
pmx: hri ktw mrc
lkl: ray iaz cvg
tpx: mwe rkv
yps: vgl
fbd: hpa lwx
khi: sjf ibj
uiq: tew rfl
shg: ibj sjf xnx
xhm: tsa
xzd: wgs hri ktw
grl: qxp
pet: gnf boa vuy
vgl: out
lwx: jvc
fyt: vfj
uej: sjh wsy oby
tiw: aox fca
cly: rpc qtg
iqy: mns cse knk
kbp: kdx
rqz: bhv rpb uej
epw: iit bup tap
ayw: xep
krk: zyn tfe kbp
kqk: ibj
aai: ray cvg
evk: ugt xxc
cus: cme gcr ypz
rqh: bho fap
fpm: uej nhi qbc
zfi: nku lgs vkb
orc: vuy
nls: dvp myq
acx: fip lzo owc
juh: vym kui
psd: kfg ril trs
ssd: vgl upm
vfj: mud
oza: drt
gsm: pfr uig sah
zuk: eup msy ipf
ohr: cpg